# Map 1
WWWWWWWWWWWWWWWW
W  T B     WWWWW
W        WWWWWWW
W          WWWWW
W  P B     WWWWW
W           WWWW
WWWWWWW   WWWWWW
W    W     T  WW
W    T         W
W          B   W
W              W
WWWWWWWWWWWWWWWW

# Map 2
WWWWWWWWWWWWWWWW
W  T   P       W
W              W
W              W
WWWW   W  WWWWWW
W  W          BW
W              W
W   WWWWWWWWWT W
W   W        W W
W      B     W W
W            W W
WWWWWWWWWWWWWWWW

# Map 3
WWWWWWWWWWWWWWWW 
WWWWWWWWWWWWWWWW 
WWWWWWWWWWWWWWWW
WWWWWWWTWWWWWWWW
WWWWWWWBWWWWWWWW
WWWWWWW WWWWWWWW
WWWWTB P BTWWWWW
WWWWWWW WWWWWWWW
WWWWWWWBWWWWWWWW
WWWWWWWTWWWWWWWW
WWWWWWWWWWWWWWWW
WWWWWWWWWWWWWWWW

# Map 4
WWWWWWWWWWWWWWWW
WWWWWWWWWWWWWWWW
WWWWWWWWWWWWWWWW 
WWWWWWTPTWWWWWWW
WWWWW BBWWWWWWWW
WWWWW TB WWWWWWW
WWWWW    WWWWWWW
WWWWWWWWWWWWWWWW
WWWWWWWWWWWWWWWW
WWWWWWWWWWWWWWWW
WWWWWWWWWWWWWWWW
WWWWWWWWWWWWWWWW

# Map 5
WWWWWWWWWWWWWWWW
WWWWWWWWWWWWWWWW
WWWWW     WWWWWW
WWWWW TBT WWWWWW
WWWWW BPB WWWWWW
WWWW  TBT WWWWWW
WWWW      WWWWWW
WWWWWWWWWWWWWWWW
WWWWWWWWWWWWWWWW
WWWWWWWWWWWWWWWW
WWWWWWWWWWWWWWWW
WWWWWWWWWWWWWWWW

# Map 6
WWWWWWWWWWWWWWWW
WWWWWWWWWWWWWWWW
WWWWWWWWWWWWWWWW 
WWWWWTW   WWWWWW
WWWWWTW B WWWWWW
WWWWWT B B PWWWW
WWWWW   W   WWWW
WWWWWWWWWWWWWWWW
WWWWWWWWWWWWWWWW
WWWWWWWWWWWWWWWW
WWWWWWWWWWWWWWWW
WWWWWWWWWWWWWWWW

# Map 7
WWWWWWWWWWWWWWWW
WWWWWWWWWWWWWWWW
WWWWWWWWWWWWWWWW
WWWWWWW   WWWWWW
WWWWW B W WWWWWW
WWWWW W  T WWWWW
WWWWW    W WWWWW
WWWWWW W   WWWWW
WWWWWWP  WWWWWWW
WWWWWWWWWWWWWWWW
WWWWWWWWWWWWWWWW
WWWWWWWWWWWWWWWW

# Map 8
WWWWWWWWWWWWWWWW 
WWWWWWWW  WWWWWW 
WWWWWWW T WWWWWW
WWWWWWPBBB WWWWW
WWWWWWT TW WWWWW
WWWWWW W   WWWWW
WWWWWW   WWWWWWW
WWWWWWWWWWWWWWWW
WWWWWWWWWWWWWWWW
WWWWWWWWWWWWWWWW
WWWWWWWWWWWWWWWW
WWWWWWWWWWWWWWWW

# Map 9
WWWWWWWWWWWWWWWW
WWWWWWWWWWWWWWWW
WWWWWWWWWWWWWWWW 
WWWWWWWWWWWWWWWW 
WWWWWWTB BTWWWWW
WWWWWW  P  WWWWW
WWWWWWTB BTWWWWW
WWWWWWWWWWWWWWWW
WWWWWWWWWWWWWWWW
WWWWWWWWWWWWWWWW
WWWWWWWWWWWWWWWW
WWWWWWWWWWWWWWWW

# Map 10
WWWWWWWWWWWWWWWW
WWWWWWWWWWWWWWWW
WWWWWWWWWWWWWWWW 
WWWWTTTTT  WWWWW 
WWWW B   B WWWWW
WWWWWWW WWWWWWWW
WWWW   B   WWWWW
WWWW  BPB  WWWWW
WWWW   W   WWWWW
WWWWWWWWWWWWWWWW
WWWWWWWWWWWWWWWW
WWWWWWWWWWWWWWWW

# Map 11
WWWWWWWWWWWWWWWW
WWWWWWWWWWWWWWWW 
WWWWWWWWWWWWWWWW 
WWWWWW     WWWWW
WWWWWW     WWWWW
WWWWWWBBBBBWWWWW
WWWWWW  P  WWWWW
WWWWWWTTTTTWWWWW
WWWWWWWWWWWWWWWW
WWWWWWWWWWWWWWWW
WWWWWWWWWWWWWWWW
WWWWWWWWWWWWWWWW

# Map 12
WWWWWWWWWWWWWWWW
WWWWWWWWWWWWWWWW
WWWWWWWWWWWWWWWW 
WWWWWWWWWWWWWWWW 
WWWW  WWWWWWWWWW
WWWW  B B B WWWW
WWWWTTT    PWWWW
WWWWWWWWWWWWWWWW
WWWWWWWWWWWWWWWW
WWWWWWWWWWWWWWWW
WWWWWWWWWWWWWWWW
WWWWWWWWWWWWWWWW

# Map 13
WWWWWWWWWWWWWWWW
WWWWWWWWWWWWWWWW
WWWWWWWWW TTWWWW 
WWWWWWWW  B WWWW 
WWWWWWWP B WWWWW
WWWWWW  B WWWWWW
WWWWWT B WWWWWWW
WWWWWT  WWWWWWWW
WWWWWWWWWWWWWWWW
WWWWWWWWWWWWWWWW
WWWWWWWWWWWWWWWW
WWWWWWWWWWWWWWWW

# Map 14
WWWWWWWWWWWWWWWW
WWWWWWWWWWWWWWWW
WWWWWWWWWWWWWWWW 
WWWWWWWWWWWWWWWW
WWWWWWP WWWWWWWW
WWWWW BB WWWWWWW
WWWW B   WWWWWWW
WWWWTTT WWWWWWWW
WWWWWWWWWWWWWWWW
WWWWWWWWWWWWWWWW
WWWWWWWWWWWWWWWW
WWWWWWWWWWWWWWWW

# Map 15
WWWWWWWWWWWWWWWW
WWWWWWWWWWWWWWWW
WWWWWWWWWWWWWWWW 
WWWWWTW   WWWWWW
WWWWWTW B WWWWWW
WWWWWT B B PWWWW
WWWWW   W   WWWW
WWWWWWWWWWWWWWWW
WWWWWWWWWWWWWWWW
WWWWWWWWWWWWWWWW
WWWWWWWWWWWWWWWW
WWWWWWWWWWWWWWWW

# Map 16
WWWWWWWWWWWWWWWW
W  T   P  B T  W
W  B B  T   B TW
WT B   B  B   TW
WWWW   W  WWWWWW
WT  B  B B   B W
WT  T  B   B   W
W B WWWWWWWWWTTW
W   WT  T  B WTW
W  B   B    TW W
WTTGB T B B TWTW
WWWWWWWWWWWWWWWW


# Map 17
WWWWWWWWWWWWWWWW
W WT B WTTW W TW
WT  B  WB  B   W
WWW   B   TW  TW
W TP B  W  B BBW
WW   W  B  T   W
WW WWWWWW WWWWWW
WT B  B   WTW  W
WWT WT  B   B TW
WTB W B  B B TWW
W   WT BTWT B TW
WWWWWWWWWWWWWWWW

# Map 18
WWWWWWWWWWWWWWWW
W  P    W      W 
WWWWW B W  BB  W
W    TTTWBBTB  W 
WWW  TTTW  TBB W 
WW  BTTTW BTB  W
W  BBTTTW  TBB W 
W   BTTTW BTB  W 
W  B    W      W 
WWWB       W   W 
W      W   W   W  
WWWWWWWWWWWWWWWW

# Map 19
WWWWWWWWWWWWWWWW
WT  TW P WTTW TW 
WWW  WW WW BW TW
WT   B      W  W 
W B B B B B W TW 
WT  B B B B W  W
W B BWWWWW  B TW 
WT   WT     W  W 
WWW  W BBBB W TW 
WT   W B  B W  W 
WT T WT  T  T TW  
WWWWWWWWWWWWWWWW

# Map 20
WWWWWWWWWWWWWWWW
W T W W    P   W 
WW      WWW   WW
WTT BWWW   WWW W 
WW  T T  B   WTW 
W  WB B  B  TWTW
W T BB   B B WTW 
WWW B B BB   W W 
W T BTTB W  BB W 
WWW BT  TWB  BTW 
W T  TT  W  WT W  
WWWWWWWWWWWWWWWW

# Map 21
WWWWWWWWWWWWWWWW
WWWWWWWWWWWWWWWW
WWWWWWWWWWWWWWWW 
WWWWWWWWWWWWWWWW 
WWWWW   WWWWWWWW
WWWW  B WWWWWWWW
WWWW      PTWWWW
WWWWWWWWWWWWWWWW
WWWWWWWWWWWWWWWW
WWWWWWWWWWWWWWWW
WWWWWWWWWWWWWWWW
WWWWWWWWWWWWWWWW
# Map 21
WWWWWWWWWWWWWWWW
WWWWWWWWWWWWWWWW
WWWWWWWWWWWWWWWW 
WWWWWWWWWWWWWWWW 
WWWW     WWWWWWW
WWWW   B WWWWWWW
WWWW PW  WWWWWWW
WWWW WT  WWWWWWW
WWWW     WWWWWWW
WWWWWWWWWWWWWWWW
WWWWWWWWWWWWWWWW
WWWWWWWWWWWWWWWW

# Map 22
WWWWWWWWWWWWWWWW
WWWWWWWWWWWWWWWW
WWWWWWWWWWWWWWWW 
WWWWWWWWWWWWWWWW 
WWWW    TWWWWWWW
WWWW  T  WWWWWWW
WWWW P   WWWWWWW
WWWW B B WWWWWWW
WWWW     WWWWWWW
WWWWWWWWWWWWWWWW
WWWWWWWWWWWWWWWW
WWWWWWWWWWWWWWWW

# Map 23
WWWWWWWWWWWWWWWW
WWWWWWWWWWWWWWWW
WWWWWWWWWWWWWWWW 
WWWWWWWWWWWWWWWW 
WWWW     WWWWWWW
WWWW WT  WWWWWWW
WWWW PW  WWWWWWW
WWWW   B WWWWWWW
WWWW     WWWWWWW
WWWWWWWWWWWWWWWW
WWWWWWWWWWWWWWWW
WWWWWWWWWWWWWWWW

# Map 24
WWWWWWWWWWWWWWWWW
W     T WWWWWWWWW     
W      WWWWWWWWWW         
W TBP     WWWWWWW        
W      B  WWWWWWW       
W   WWWWWWWWWWWWW          
WWWWWWWWWWWWWWWWW   

#Map 25
WWWWWWWWWWWWWWWWW
W     T WWWWWWWWW     
W      WWWWWWWWWW         
W TBP     WWWWWWW        
W  B    B  WWWWWW       
W  T WWWWWWWWWWWW         
WWWWWWWWWWWWWWWWW 